Alessandra Aline Vidal Santos dos Anjos	Alessandra Aline Vidal Santos dos Anjos	alessandra.anjos
Beatriz de Souza Alemida Nascimento	Beatriz de Souza Alemida Nascimento	beatriz.nascimento
Beatriz Marcelino de Jesus	Beatriz Marcelino de Jesus	beatriz.jesus
Edilane Oliveira Ramos	Edilane Oliveira Ramos	edilane.ramos
Eliane Garcia Melgaco	Eliane Garcia Melgaco	eliane.melgaco
Ellen Karoline da Silva	Ellen Karoline da Silva	ellen.silva
Enzo Pallos de Oliveira Silva	Enzo Pallos de Oliveira Silva	enzo.silva
Erica Silva	Erica Silva	erica.silva
Francisco Hiczy da Costa	Francisco Hiczy da Costa	fhc
Isaque Cunha da Silva	Isaque Cunha da Silva	isaque.silva
Jessica do Nascimento Sena	Jessica do Nascimento Sena	jessica.sena
Leticia Freire Ribeiro	Leticia Freire Ribeiro	leticia.ribeiro
Luciana Martins Costa	Luciana Martins Costa	luciana.costa
Marcelo Caetano	Marcelo Caetano	marcelo.caetano
Milena Moraes de Oliveira	Milena Moraes de Oliveira	milena.moraes
Monique Mendes Roque	Monique Mendes Roque	monique.roque
Olivia Lauriucci Arantes Vieira Bragato	Olivia Lauriucci Arantes Vieira Bragato	tolivia.bragato
Ramon Montes dos Santos	Ramon Montes dos Santos	ramon.santos
Raquel Yamagut Chaud	Raquel Yamagut Chaud	raquel.chaud
Rian Victor Faria Goncalves Silva	Rian Victor Faria Goncalves Silva	rian.silva
Tamires Freitas Oliveira	Tamires Freitas Oliveira	tamires.oliveira
Tifanny Gomes de Almeida	Tifanny Gomes de Almeida	tifanny.almeida
